NO textures/wood0.xpm          
SO textures/wood1.xpm
WE textures/wood2.xpm
EA textures/wood3.xpm
F 81,41,28
C 53,168,230

1111
1101111111
10101111011
100N111111
1110111111
11111
