NO textures/wood0.xpm          
SO textures/wood1.xpm
WE textures/wood2.xpm
EA textures/wood3.xpm
F 81,41,28
C 53,168,230


11111
  11111
1 1N1
11101
11111
